1111111111111
1001000P000C1
10E0010011111
100001000C001
1111111111111