11111111111111111111
1P00E10C000000000001
100C0000111111111111
10C001000C0C0C0C0C01
11111111111111111111