1111111111111
1P010000000C1
1000010011111
10C001000C0E1
1111111111111