1111111111111
10010000000C1
1010011111001
11P11E0000011
1111111111111