11111111111111111111111111111111111111111111111111111
1P0E0111001111111111111111111111111111111111111111111
10C001000C0000000000000000000000000000000000000000001
11111111111111111111111111111111111111111111111111111